################
#              #
#  2           #
#              #
#              #
#              #
#              #
#              #
#              #
#              #
#              #
#              #
#              #
#          1   #
#              #
################

